11111111111111111111111111111111111111111111111111
10000000000000001100000000000000000000000000002111
11111111111111000001111111111111111111111111111111
11111111111111111000000000211111111110002111111111
11111111111111111111111011111111111110111111111111
11111111111111111111111000000000000000111111111111
11111111111111111111111111111111111111111111111111